#..............................#.................##..............................#.................#
#..............................#..................#..............................#..................
....................................................................................................
....................................................................................................
....................................................................................................
....................................................................................................
....................................................................................................
....................................................................................................
....................................................................................................
....................................................######..........................................
..................................................###...............................................
.................................................#.................................................#
.................................................#..................................................
E.....................E..........................#.........................................E.......#
###########.######################################.###########......################################
.................................................#...............###................................
.................................................#..............##..................................
.................................................#.............##...................................
.................................................###############....................................
#.......................#.........................#.......................#.........................
#.......................#.........................#.......................#.........................
#.......................#.........................#.......................#.........................
#.................................................#.................................................
#.......................#......#.................##.......................#......#.................#
