#..............................#..................
#..............................#..................
..................................................
..................................................
..................................................
..................................................
..................................................
..................................................
..................................................
..................................................
..................................................
.................................................#
..#...#..........#......#........#.....#....#..#.#
.................................................#
##################################################
..................................................
..................................................
..................................................
..................................................
#.......................#.........................
#.......................#.........................
#.......................#.........................
#.................................................
#.......................#.........................
