#..............................#.................#
#..............................#..................
..................................................
..................................................
..................................................
..................................................
..................................................
..................................................
..................................................
..................................................
..................................................
.................................................#
..#...#..........#......#........#.....#....#..#.#
.................................................#
###########.######################################
..................................................
..................................................
..................................................
..................................................
#.......................#.........................
#.......................#.........................
#.......................#.........................
#.................................................
#.......................#......#.................#
